11111111
1110E001
11101111
10P00001
10CCC001
11111111
