1111111111
100E00C001
1000000001
1111111101
1P00000001
1111111111
