1111111111111
1110000C00111
1111011110111
1010011110001
10100111111C1
100001111C1C1
100001111CCC1
100000P011111
10E0000011111
1111111111111
