111111111111111
111000110001101
1110E0000C01101
1C0000110000001
111110111111001
111110111111001
1P0000000001001
111111111101001
111111111101001
1C1C0000C101001
101110101100001
100000100001111
111111111111111
