111111111111111
1110001100011E1
111000000C01101
1C0000110001101
111110111111101
111110111111101
1P0000000001101
111111111101101
111111111101101
1C1C0000C101101
101110101100001
100000100001111
111111111111111
