1111111111111
1110000C00111
1111011110111
1010011110001
10000111111E1
10C001111C1C1
1P0001111CCC1
1000011111111
1000011111111
1111111111111
