1111111111111111
1000000000000011
10110000C0000001
1011000EP0001111
1011000C00001111
1110000000001111
1111111111111111
