1111111111111
1010000C00111
1000011000111
1011111000001
1011111001001
1000011111101
1000011000001
1P0001100E001
1000011000001
1111111111111
