1111111111111111
11000111110C1001
11C00000C00P1001
1111101111001101
1111101111000001
1E000C0000001001
1111111111111111
