1111111111
1100011111
11C00000C1
1111101111
1111101111
1E000C00P1
1111111111
