1111111111111
100010C011001
1000100011111
1111100011111
1000000000001
10P00000000E1
1000000111111
1110000110001
1110000110001
1111111111111
