111111111
1000110E1
100011001
111011101
1110P00C1
111111111
