1111111111111111
1000000000001111
10110000C0001111
1011000EP0001111
1011000C00000001
1110000000001111
1111111111111111
