1111111
1PC0111
1E11101
1011111
1111111
