111111
10E001
1P00C1
100001
111111
